9
8
#########
#I ######
### #####
####  ###
##### ###
#### ####
###S#####
#########