10
11
##########
#I####   #
## ## ####
### # ####
##### ####
# # # ## #
# ##  # ##
# # ### ##
# # ### ##
#S##   # #
##########